type octile
height 21
width 21
map
.............@.......
.@.@.@.@@@.@.@.@@@.@.
...@.................
@@.@.@.@.@@@.@.@@@.@.
.....@.@.......@.....
.@.@.@.@@@.@.@.@.@@@.
...................@.
.@@@.@.@.@@@.@.@.@.@.
...............@.@...
.@.@.@.@.@@@.@.@.@.@.
...@.............@...
.@.@.@@@.@@@.@.@.@.@.
.@.@...@.......@.....
.@.@.@.@.@.@.@@@.@@@.
...@.....@.@.........
@@.@.@.@.@.@.@.@@@@@.
.......@...@.@.......
.@.@@@.@.@.@.@...@.@.
.@.....@.........@...
.@.@@@.@@@.@.@@@.@.@.
.....................
